96,16,2,2,Long Map
11111111111111111111111111111111111111111111111111111111111111111111111111111111111111111111111
10000000000000000000000000000000000000000000000000000000000000000000000000000000000000000000001
10000000000000000000000000000000000000000000000000000000000000000000000000000000000000000000001
11111112021111111303111111110111111114041111111101111111110111111111011111111101111111111111111
11111111011111111101111111110111111114041111111101111111110111111111011111111101111111111111111
11112222022221111101111111110111111114041111111101111111110111111111011111111101111111111111111
11112000000021111101111111110111111114041111111101111111110111111111011111111101111111111111111
11112000000021111101111111110111111114041111111101111111110111111111011111111101111111111111111
11112000000021111101111111110111111114041111111101111111110111111111011111111101111111111111111
11112222022221111101111111110111111114041111111101155555510155555551015555555101111111111111111
11111111013333333303333333310111111114041111111500000000000000000000000000000005111111111111111
11211111013000000000000000310111111114041111111500020003330040044440000040000005111111111111111
12021111013000000000000000310111111114041111111500222000300040040040055444550005111111111111111
12021111013000000000000000310111111114041111111500020000300044440040000040000005111111111111111
12000000013000000000000000310111111114041111111500000000000000000000000000000005111111111111111
11111111113333333333333333311111111114441111111555555555555555555555555555555555111111111111111