28,17,2,2,Test Map
11111
1000111111111111111111111111
1000000000000000000000000001
1000111111111000111111111101
1111100000000000111111111101
0000102011111111100000000101
0000100011111111100000000101
0000103011111000000000000101
0000100000000000000500000101
0000103011111000000000000001
0000100011111000000000000111
11111020111111111111111111
10000000000000000000000001
1000000022202220000000000222
1000000020000020000000000002
1000000020040020000000000222
11111111111111111111111111